6 9
1000
# # S # # #
# R . . * #
# . . . . #
# . . . . D
# . # . - D
# . . . . #
# . . . . #
# . * . H #
# # # # # #