32 18
# # # # # # # # # # # # # # # # # # # # # # # # # # # # # # # # 
# . . . . . . . . . . . . . . . . . . . . . . . . . . . . . . #
# . . . . . . . . . . . . . . . . . . . . . . . . . . . . . . #  
# . . . . . . . . . . . . . . . . . . . . . . . . . . . . . . #
# . . . . . . . . . . . . . . . . * . . . . . . . . . . . . . #
# . . . . . . . . . . . H # # # # # # # # # . . * * * * * . . # 
# . . . . . . . . . . . H . . . . . . . . . . . . . . . . . . #
# . . . . . . . . . . . H . . . . . . . . . . . . . . . . . . #
# . . . . . . . . . . . H . . . . . . . # # # # # # # # # - - #  
# . . . . . . . . . . . H . . . . . . . . . . . . . . . . . . #
# . . . . . . . . . . . H . . . * * . . . . . . . . . . . . . #
# . . . . . . . # * # . H . . . # # # # # H . . . . . . . * . #   
# * . . . . . # . . . . . . . . . . . . . H . . . . . * . . . #
# - - - - - - . . . . . . . . . . . . . . H . . . . . . . . * #
# . . . . . . . . . . . . . . . . . . . . H . . . . . * . . . #  
D . . . . * . . * * . . . . . . . . . . . H . . . . . . . . . D
D . . . # # * * * * * * * * * * * * * * * H * . . . . . . . . D
# # # # # # # # # # # # # # # # # # # # # # # # # # # # # # # # 